NO    ./path_to_the_north_texture

R 1000 1000
SO ./path_to_the_south_texture
WE ./path_to_the_west_texture
C 225,00,0

EA ./path_to_the_east_texture
S ./path_to_the_sprite_texture

F 220,100,0
  1111  111
111001  101
100001  111
 1111

   11111111
    1111000111
      111111
